name	description	note
Acoustic	アコースティック楽器を中心としたアレンジ	
Jazz	ジャズ系アレンジ	
Rock	ロック系アレンジ	
Metal	メタル系アレンジ	
Electronic	エレクトロニック系アレンジ	
House	ハウス系アレンジ	
Trance	トランス系アレンジ	
Hardcore	ハードコア系アレンジ	
Classical	クラシック調アレンジ	
Folk	民族音楽的アレンジ	
Piano	ピアノ系アレンジ	
Orchestra	オーケストラ系アレンジ	
Eurobeat	ユーロビート系アレンジ	
Drum'n'Bass	ドラムンベース系アレンジ	
Ambient	アンビエント系アレンジ	
Chiptune	チップチューン系アレンジ	
Game Music	ゲーム音楽風アレンジ	
Fusion	フュージョン系アレンジ	
Dubstep	ダブステップ系アレンジ	
Traditional	和風アレンジ	